11111111111111111111111111
10000000000000000000000001
10011111110000001111111001
10010000010000001000001001
10010000010000001000001001
10011111110000001111111001
10000000000000000000000001
10000000000000000000000001
10000100000000000001000001
10000111111111111111000001
10000000000000000000000001
11111111111111111111111111
