1111111111111
1010000000001
1010000001001
1000000001001
1001000001001
1000011100001
1000000000001
1111111111111
