11111111111111111111111111111
10010000010000010000010000011
11001001001001001001001001001
10010010010010010010010010011
11001001001001001001001001001
10010010010010010010010010011
11001001001001001001001001001
10010010010010010010010010011
11001001001001001001001001001
10010010010010010010010010011
11001001001001001001001001001
10010010010010010010010010011
11001001001001001001001001001
10010010010010010010010010011
11001001001001001001001001001
10010010010010010010010010011
11001001001001001001001001001
10010010010010010010010010011
11001001001001001001001001001
10010010010010010010010010011
11000001000001000001000001001
11111111111111111111111111111
